Pocket Casts はリスナーによる、リスナーのための世界で最も強力なポッドキャストプラットフォーム / アプリです。Pocket Casts にはリスニング、検索、検出のための高度なツールが搭載されています。 厳選されたおすすめのポッドキャストのなかから興味を惹かれるものを簡単に見つけて、登録する手間なくお気に入りをシームレスに楽しむことができます。

メディアの声:
Wired:「Pocket Casts はすべての iPhone ユーザーが求めていたポッドキャストアプリ」
iMore:「Pocket Casts は iPhone で最高のポッドキャストアプリ」

独自のシンプルかつパワフルな機能と制限のないポッドキャストデータベースで、お気に入りのものがきっと見つかります。

細部への配慮
デザイン: 新しいポッドキャストを簡単に再生、管理、検索できます。
テーマ: ダークテーマとライトテーマどちらでも好きな方を使用できます。 有機 EL デバイスを使用しているユーザー向けにエクストラダークテーマも用意されています。
ユニバーサル: 独自でありながら iPad に似たインターフェースで、Slide Over、Split View、ピクチャーインピクチャーに対応しています。
すべてに対応: CarPlay、AirPlay、Chromecast、Sonos。 これまでにないほど幅広い場所でポッドキャストを聴くことができます。

強力な再生機能
次のエピソード: お気に入りの番組をもとに再生キューを自動的に構築します。 ログインすると、すべてのデバイスで次のエピソードキューが同期されます。
無音時間のカット: エピソードから無音時間がカットされるため、エピソードの再生時間が短縮され、時間も節約できます。
速度調整: 0.5倍速～3倍速の範囲内で再生スピードを変更できます。
ボリュームブースト: 背景ノイズを軽減しながら、声を大きくできます。
ストリーム: 好きな時にエピソードを再生できます。
チャプター: チャプターを簡単に切り替えたり、投稿者が追加した埋め込みアートワークを楽しんだりできます (フォーマットが MP3 と M4A のチャプターをサポート)。
音声と動画: お気に入りエピソードの再生、動画から音声への切り替えを行うことができます。
スキップ再生: エピソードのイントロをスキップしたり、指定した間隔でエピソードをスキップしたりできます。
Apple Watch: スマートフォンに触れることなく、Apple Watch アプリから再生を制御したり、音量の調整や再生エフェクトの変更を行うことができます。
スリープタイマー: 設定した時間になるとエピソードが一時停止されるので、安心して眠りにつくことができます。
Airplay & Chromecast: 簡単な操作でエピソードを TV やスピーカーで再生できます。
Sonos: Sonos アプリから直接ポッドキャストのコレクションを検索、再生できます。
CarPlay: 運転中でもポッドキャストを再生できます。

スマートなツール
同期: サブスクリプション、次のエピソード、リスニング履歴、プレイバック、フィルターがすべてクラウドで安全に保存されます。 他のデバイスだけでなく、Web でも前回再生したところから続きを聴くことができます。
リフレッシュ: 新しいエピソードがサーバー側で自動的にチェックされるため、面倒な手間もかかりません。
通知: 必要に応じて、新しいエピソードが公開された時に通知を受け取ることができます。
自動ダウンロード: オフラインでも再生できるように、エピソードが自動的にダウンロードされます。
フィルター: カスタムフィルターでエピソードを整理できます。
ストレージ: ポッドキャストの整理に必要なツールがすべて揃っています。

人気の機能
検索: iTunes などで好きなポッドキャストに登録できるだけでなく、 チャート、ネットワーク、カテゴリーを基準に検索できます。
共有: お気に入りのポッドキャストとエピソードを他のユーザーと共有できます。
OPML: OPML をインポートできるため、手動でポッドキャスト情報を設定する必要がありません。 コレクションをいつでもエクスポートできます。

Pocket Casts にはあらゆるユーザーのニーズに対応する、強力かつシンプルな機能がまだまだ搭載されています。 ぜひダウンロードしてお試しください。

Pocket Casts がサポートする Web サイトとプラットフォームの詳細については pocketcasts.com をご覧ください。
